{
  "project_id": "",
  "total_steps": 30,
  "completed_steps": 2,
  "completed_step_ids": [
    "01-01",
    "01-02"
  ],
  "pending_step_ids": [
    "01-03",
    "02-01",
    "02-02",
    "02-03",
    "02-04",
    "02-05",
    "03-01",
    "03-02",
    "03-03",
    "04-01",
    "04-02",
    "04-03",
    "04-04",
    "04-05",
    "05-01",
    "05-02",
    "05-03",
    "05-04",
    "06-01",
    "06-02",
    "06-03",
    "06-04",
    "06-05",
    "07-01",
    "07-02",
    "08-01",
    "08-02",
    "08-03"
  ],
  "all_steps_done": false,
  "phases_completed": {}
}